baa	R	v	borrow, owe
haa	R	n	tooT, teeT
kaa	L	v	burn (intr.)
xaa	L	n	body lice
naa	L	n	work
naa	L	n	leaf; cf. work
Naa	L	v	stop
Naa	F	n	fish
Naa	R	e	five
paa	F	n	faTer
paa	L	n	male
paa	F	v av	Tin
Paa	L	v av	good
saa	F	n	animal, meat
saa	R	v av	hot (temperature)
tsaa	F	n	child; cf. tsápâng
tsaa	L	n	small, dear; diminutive
vaa	F	n	bird
vaa	R	n	river, stream, creek
zaa	F	v	hear, smell
bEE	F	n	bean, pea
ee	F	p	final clause marker
hEE	F	v	understand, know
xEE	F	n	spoon
mEE	L	n	curry
nEE	F	v	eat
vEE	R	v	look at, watch
xee	L	v	fall, decrease, drop; fail exam
see	F	v	broken, break down, spoiled, bad
tsee	L	v	go, walk
hii	L	v	copula, ‘be’
xii	R	n	bead, necklace (beaded)
lii	R	e	four
nii	L	e	two
nii	R	n	day, sun
pii	R	n	grandmoTer
pii	F	ad	great, major
Tii	R	n	deaT
gOO	R	v	dry, wiTered (from liquid to dry)
hOO		p	plural  marker on nouns
mOO	L	v av	wrong, guilty
poo	L	ad	negative marker
TOO	R	n	fence
boo	F	v	spill, Trow out (e.g. garbage), sT. becomes useless
goo	R	n	bamboo (large sp.)
xoo	R	n	village; khúo pîi ‘capital city, town’
koo	F	e	nine
koo	L	n	hole (in ground), pit, cave, grave
poo	F	v	carry (back, car)
buu	F	n	nest; vá !bûu ‘bird’s nest’
buu	L	n	meal, food, cooked rice
guu	L	n	bone
Luu	L	v	fall (over), e.g. tree, person
ii muu	R	vc	sleep
luu	R	n	head; also lú búq
muu	L	v	see, find
muu	R	n	hawk
muu	F	n	seed (to plant, in fruit); pit
nuu	F	n	moTer
nuu	L	n	female
puu	R	n	grandfaTer, uncle
puu	R	v	carry (on head, shoulder)
suu	L	v	pound, punch
Tuu	F	n	word
Tuu	L	v ? n ?	paste, in compounds: bé Tùu ‘soybean paste’
tuu	F	ad	now
uu	L	ad	mark of plural person on verbs, plural possessor on nouns
kal	R	v	climb, ascend
kal	F	n	kidney
kal	L	v	dig up
Tal	F	n	bow
Tal	L	v	choke
Tal	R	n	lying face up
kil	L	n	button
pil	R	v av	clever, intelligent
Til	R	n	Ting
til	F	n	testicle
mOl	L	n	stick
xul	R	n	cave
dam	R	v	healTy, well (not sick)
gam	R	n	land, forest, wild
kam	R	n	mouT
kam	L	n	button
nam	L	v	kiss (e.g. on cheek)
sam	F	n	hair
tam	F	v	many, abundant
tam	F	v	touch
tsEm	R	n	knife
lim	F	n	picture, map
sim	R	v	count, read
Tim	R	v av	dark (e.g. dense forest)
tsim	F	v	be sick of
mOm	F	n	spider
tsOm	F	v av	short
vOm	R	v av	black
dum	R	v av	dark blue
kum	F	v	descend
kum	L	n	year
lum	L	v	lie down
sum	R	n	silver, money, wealT
sum	F	n	mortar
Tum	R	e	Tree
man	L	n	price
san	R	v av	red
Tan	L	n	worm (in body)
xEn	R	v	divide, separate
in	F	n	house
in	L	k	ergative marker
LOn	L	ad	mark of dual person on verbs, dual possessor on nouns
vOn	L	n	cloTing
vun	L	n	skin (generic)
kaN	R	v av	skinny, Tin; cf. mòl káN ‘stick’
xaN	L	v	awake, wake up
laN	R	n	half, side
naN	F	p	you sg., your sg.
naN	F	n	bush, plant
EN	R	v av	green, yellow, blue
diN	R	v	stand
diN	L	ad	future marker; dìng áa ‘for benefit of’
TiN	F	n	tree, wood; TíN `káN ‘Tin branches’
tiN	R	n	upper back; hump (ox)
tsiN	L	v av	wise
tsiN	R	v av	complete, perfect
buN	L	v	pourqspread out (liquid, oTer Tings)
huN	F	v	come; become (preposed to main verb)
luN	F	n	worm, maggot
PuN	R	n	trunk (of tree), tribe, plantqtree of someTing
pON	L	n	bell
puN	R	v	increase, multiply
suN	F	v	pour (e.g. water)
zuN	F	n	root, finger, toe, tendon
bOw	F	v	bump (e.g. on ground), bumpy; hump on cow
gow	L	n	property, treasure
how	L	n	religion
low	R	n	medicine
low, lowq	L	ad	not
now	F	n	seedling, young (animal)
Tow	F	v	get up (< bed, ground); win a fight
Tow	L	n	fly
tow	R	v	sit
bay	L	v av	easy, cheap
Lay	R	v	run
laay	L	v av	cheap
hey	R	v	change (mentally), turn (sT) around
hey	L	n	axe
Ley	F	v	transfer (sT.) from one Ting to anoTer
ley	L	n	bridge
ley	F	n	earT
ley	R	n	tongue
mey	R	n	cloud
mey	F	n	fire
mey Tal	FL	nc	gun
pey	R	v	spin
sey	F	v	speak, say
Tey	L	v	know; mùu Tèy ‘be visible’
vey	L	v	strike, spank (e.g. wiT stick)
vey	L	n	time, occasion; cf. khàt vèy ‘one time’
vey	F	ad	left (side)
hOy	L	v	beautiful
xOy	L	v	picking action (finger, stick wiT a hook)
kOy	L	v	place, put (down), keep
tuy	R	n	good taste
tuy	F	n	water
uy	F	n	dog
gaal	R	n	war, enemy, battle, rival
zaal xun	L	nc	bed
bEEl	R	n	pot
kEEl	L	n	goat
bOOl	R	v	do; compose (song)
TOOl	R	n	fit (e.g. cloTes; someTing inside someTing)
tsOOl	F	v	exhausted, be tired
tsOOl	L	v	rest; also tsòol dòo (cf. exhaust)
mool	R	n	hill
tool	R	n	ground
guul	R	n	snake
skûul	F	n	school
Laam	R	n	temporary tent
bEEm	F	n	circle, round, circular
zEEm	F	v	decorate
neem	F	v	lower, be in a lower position, short (obj.)
Teem	F	v	know how, able, skillful
liim	L	n	shade 
liim	R	v av	wise
Niim	R	v av	clean
bOOm	F	n	round open basket made of bamboo; net, trap
hOOm	R	v	share
pOOm	F	v	swell
sOOm	L	e	ten
tsOOm	R	v	shrink
xoom	L	n	post, pole
luum	F	v	round (solid)
Laan	L	n	cemetary, grave
lEEn	L	n	fishing net
nEEn	L	v av	dirty
sEEn	R	n	newborn
leen	L	v av	big
dOOn	R	v	drink
dOOn	L	v	sprout
dOOn	L	v	bud, sprout
xOOn	L	n	cup
boon	R	n	mud
moon	F	v	decay, rot, rotten, overripe
poon	F	n	cloT
tsoon	F	v	move (someTing somewhere)
kaaN	R	v av	white
saaN	R	v av	high, tall; sáang ‘height’
TaaN	F	n	trap
zaaN	F	v	light (weight)
zaaN	R	n	plain (land)
bEEN	R	n	back basket
bEEN	L	v	beat (wiT bare hands)
kEEN	F	n	leg
mEEN	F	n	cat
teeN	F	n	spear
TeeN	R	v	clean, holy
ziiN	R	n	twilight; zìing léq ‘tomorrow’; à zìing táa è ‘it’s dark’
bOON	R	n	cow
dOON	F	v	young, soft
gOON	R	v  av	skinny, Tin
xOON	R	v	weave into cloT
kOON	F	n	waist
kOON	R	n	basket
NOON	R	n	neck
zOON	R	n	monkey
LooN	R	n	floor
xooN	R	n	drum; bowl
kooN	R	n	boat, plate, dish
looN	R	n	log (on ground)
duuN	R	n ?	along Te way
xaaw	R	n	rope; bag (made of cloT); sá kha&aw ‘bag’
naaw	R	n	child, baby, young, issue, generation
paaw	L	n	language
nEEw	F	v	small
laay	L	v	dig
Naay	R	v	listen to, love, like
saay	R	n	elePant
kOOy	R	v	embrace, hug
kOOy	L	n	bait
luuy	L	v av	old (Ting), e.g. lów lùuy ‘old field’
luuy	L	n	river
nuuy	R	v	smile, laugh
tuuy	R	n	egg
tsiq	L	v	strong (e.g. coffee)
dap	L	v	cold (temperature)
kap	L	v	cry
nap	L	n	snot, nasal mucus
zEp	L	v	swim
sEp	L	v	Trow (at)
tEp	L	v	taste (food)
tsip	L	v	broken to pieces
mOp	L	v	regirgitate (moTer to baby)
tup	L	v	aim (e.g. an arrow), to aim (to do someTing)
gOt	F	v ?	naked
xat	L	e	one
mat	L	n	bedbug, louse
pat	L	n	fibre, Tread
dEt	L	v av	firm
pEt	L	v	bite
NEt	L	v	decay (e.g. paper, wood)
hit	L	n	louse, lice; sá hìt ‘bigger lice on animals’
kOt	L	n	door
vOt	L	v	cold (freezing cold, more Tan dàp)
vOt	L	n	leech
xut	L	n	hand
vut	L	n	ashes, dust
kaap	F	v	shoot
Tep	L	n	skill (from ‘know’)
sEEp	R	v	remove rice chaff (shaking up and down)
zEEp	R	v	whip
leep	F	n	shade, overcast (sun going downqcovered by clouds)
tsiip	F	v	drink (animals only)
sOOp	F	v	wash (Tings)
tsOOp	F	v	suck, kiss (on mouT)
doop	F	n	big round Ting for drying (e.g. rice)
hoop	F	v	cover up to include everyTing (Pysically, mentally)
Toop	F	v	stack (stuff one on anoTer), layer (on e.o.)
tsoop	F	n	lung
guup	L	e	six
aat	F	v	cut (rice paddy), meat, slash
paat	F	n	lake (mostly dirty)
Paat	F	n	time, clock
saat	F	v	cut
hEEt	F	n	knowing, knowledge
geet	F	e	eight
gOOt	R	v	grind
moot	F	v av	decayed
puut	F	v	emerge from (e.g. a forest spring)
luut	F	v	enter, join (army)
aq	R	n	fowl, chicken
baq	F	n	branch
baq	R	v	feed into someone’s mouT (human, baby)
haq	R	v	hard, difficult, cheap
laq	L	p	among
naq	R	n	nose
paq	R	v	flower, bloom
taq	R	v	hard, solid
taq	L	ad	very (postp)
Taq	F	v av	new
vaq	R	v	serve food, feed (but not directly)
vaq	R	v	illuminate (tr & intr), bright
bEq	L	v	attach, be attached
LEq	F	v	exchange
kEq	F	n	lightening, Tunder?
mEq	R	v	squeeze, ooze, exude, press
PEq	R	n	mat
sEq	L	n	hammer
tEq	R	v av	old (person)
geq	F	v	sleep overnight
diq	L	v av	true, real, right, correct
giq	L	v	heavy, weigh 
niq	F	n	skirt
tsiq	L	n	wisdom (cf. tsìN ‘wise’)
Teq	R	v	sweep, wipe, clean (dust, water)
teq	F	v av	tight
bOq	R	n	bump (e.g. on head), swelling
vOq	L	n	pig
buq	F	n	hut, tent
muq	L	n	lip
suq	L	v	downhill
suq	L	n	pestle
Tuq	F	v av	deep, sour
boq	R	v av	unclean, unholy, dirty (Pysical or spiritual)
boq	R	n	dust (e.g. in Te eye)
poq	R	v	expand, swell
vEy	L	n	gas; wind per anum
a		p	3pers subject marker
ka		p	1pers subject marker (dualqpl marks excl)
na		p	2pers subject & object marker
na	H	ad	past tense marker
pasal	L	nc	man
sa iq		vc	belch; à sá ìq êe ‘he’s belching’
sagi	L	ec	seven
lE	L	c, p	wiT, and
hi tse	HH	dc	Tis
i		p	1pers inclusive subject marker; 1pers object
xu tse	HH	dc	Tat
ni		p	marker of 2pers subject + 1person object
nu mEy	L	nc	woman
